1111111111
10C0000001
100P00C001
1E0000C001
10C0000001
100000CC01
1000000001
1111111111
