1111111111111111111111111111111111
10E00000P0000010C00000C00000000001
1000000100100010101001000000010101
1010010010101010001001000000010101
100000000C10C0100000000000000001C1
1111111111111111111111111111111111
